1 1 1 1 1 1 1 1 1 1 1 1 1 1 1 1 1 1 1 1
1 1 1 1 1 1 1 1 1 1 1 1 1 1 1 1 1 1 1 1
1 1 1 1 1 1 1 1 1 1 1 1 1 1 1 1 1 1 1 1
3 0 0 0 0 0 0 0 0 0 0 2 2 2 2 2 2 0 0 3
3 0 0 0 0 0 0 0 0 0 0 2 2 2 2 2 2 0 0 3
3 0 0 0 0 0 0 0 0 0 0 2 2 8 8 2 2 0 0 3
3 0 0 0 0 0 0 0 0 0 0 0 0 0 0 0 0 0 0 3
3 2 2 2 2 2 2 2 0 0 0 0 0 0 0 0 0 0 0 3
3 2 2 2 2 2 2 2 0 0 0 0 0 0 0 0 0 0 0 3
3 2 2 7 7 2 2 2 0 0 0 0 0 0 0 0 0 0 0 3
3 0 0 0 0 0 0 0 0 0 0 0 0 0 0 0 0 0 0 3
3 0 0 0 0 0 0 0 0 0 0 0 0 0 0 0 0 0 0 3
1 1 1 1 1 1 1 1 1 1 1 1 1 1 1 1 0 0 0 3
1 1 1 1 1 1 1 1 1 1 1 1 1 1 1 1 0 0 0 3
1 1 1 1 1 1 1 1 1 1 1 1 1 1 1 1 5 5 5 3