1 1 1 1 1 1 1 1 1 1 1 1 1 1 1 1 1 1 1 1
1 1 1 1 1 1 1 1 1 1 1 1 1 1 1 1 1 1 1 1
1 1 1 1 1 1 1 1 1 1 1 1 1 1 1 1 1 1 1 1
2 2 2 2 2 2 2 2 2 2 2 2 2 2 2 2 6 6 6 3
2 2 2 2 2 2 2 2 2 2 2 2 2 2 2 2 0 0 0 3
2 2 2 2 2 2 2 2 2 2 2 2 2 2 2 2 0 0 0 3
4 4 4 4 4 4 4 4 4 4 4 4 4 4 0 0 0 0 0 3
4 0 0 0 0 0 0 0 0 0 0 0 0 0 0 0 0 0 0 3
4 0 0 0 0 0 0 0 0 0 0 0 0 0 0 0 0 0 0 3
4 4 4 0 0 4 4 4 4 4 4 0 0 4 0 0 0 0 0 3
0 0 4 0 0 4 0 0 0 0 4 0 0 4 0 0 0 0 0 3
0 2 2 8 8 2 2 0 0 2 2 7 7 2 2 0 0 0 0 3
0 2 2 2 2 2 2 0 0 2 2 2 2 2 2 0 0 0 0 3
0 2 2 2 2 2 2 0 0 2 2 2 2 2 2 0 0 0 0 3
3 3 3 3 3 3 3 3 3 3 3 3 3 3 3 3 3 3 3 3 