0 0 0 0 0 0 0 0 0 0 0 0 0 0 0 0 0 0 0 0
0 0 0 0 0 0 0 0 0 0 0 0 0 0 0 0 0 0 0 0
1 1 1 1 1 1 1 1 1 1 1 1 1 1 1 1 1 1 1 1
4 0 0 0 0 0 0 0 0 0 0 3 0 0 0 0 3 0 0 3
4 0 0 0 0 0 0 0 0 0 0 4 0 0 0 0 3 0 0 3
4 0 0 0 0 0 0 0 0 0 0 5 1 1 1 1 6 0 0 3
4 0 0 0 0 0 0 0 0 0 0 0 0 0 0 0 0 0 0 3
4 7 2 2 2 2 2 8 0 0 0 0 0 0 0 0 0 0 0 3
4 4 0 0 0 0 0 3 0 0 0 0 0 0 0 0 0 0 0 3
4 5 1 1 1 1 1 6 0 0 0 0 0 0 0 0 0 0 0 3
4 0 0 0 0 0 0 0 0 0 0 0 0 0 0 0 0 0 0 3
4 0 0 0 0 0 0 0 0 0 0 0 0 0 0 0 0 0 0 3
2 2 2 2 2 2 2 2 2 2 2 2 2 2 2 3 0 0 0 3
0 0 0 0 0 0 0 0 0 0 0 0 0 0 0 3 0 0 0 3
0 0 0 0 0 0 0 0 0 0 0 0 0 0 0 3 2 2 2 3